acknowledgment->acknowledgement
amortized->amortised
analyze->analyse
analyzed->analysed
analyzer->analyser
analyzers->analysers
analyzes->analyses
analyzing->analysing
artifact->artefact
artifacts->artefacts
authorization->authorisation
authorize->authorise
behavior->behaviour
behaviors->behaviours
canceled->cancelled
canceling->cancelling
capitalize->capitalise
catalog->catalogue
center->centre
centimeter->centimetre
centimeters->centimetres
centralize->centralise
characterization->characterisation
characterized->characterised
color->colour
coloring->colouring
colors->colours
counselor->counsellor
criticize->criticise
criticized->criticised
criticizes->criticises
crystallization->crystallisation
customized->customised
customizing->customising
defense->defence
dialog->dialogue
digitize->digitise
digitizing->digitising
emphasized->emphasised
endeavor->endeavour
finalize->finalise
flavor->flavour
flavors->flavours
generalization->generalisation
generalizations->generalisations
generalize->generalise
generalized->generalised
generalizes->generalises
honor->honour
initialization->initialisation
initialize->initialise
initialized->initialised
initializes->initialises
initializing->initialising
kilometer->kilometre
kilometers->kilometres
labeled->labelled
labeling->labelling
labor->labour
legalize->legalise
license->licence
maneuver->manoeuvre
maneuvers->manoeuvres
memorize->memorise
meter->metre
meters->metres
millimeter->millimetre
millimeters->millimetres
minimization->minimisation
minimize->minimise
minimized->minimised
minimizes->minimises
minimizing->minimising
miter->mitre
modeled->modelled
modeling->modelling
mold->mould
nasalization->nasalisation
neighbor->neighbour
neighbors->neighbours
normalize->normalise
normalized->normalised
normalizes->normalises
optimization->optimisation
optimizations->optimisations
optimized->optimised
optimizer->optimiser
organization->organisation
organizations->organisations
organize->organise
organized->organised
plagiarize->plagiarise
practice->practise
prioritize->prioritise
prioritizing->prioritising
publicize->publicise
realize->realise
realized->realised
recognize->recognise
recognized->recognised
recognizes->recognises
regularization->regularisation
regularize->regularise
regularized->regularised
regularizes->regularises
reinitialize->reinitialise
reinitialized->reinitialised
reorganization->reorganisation
reorganized->reorganised
sanitize->sanitise
sanitized->sanitised
serialization->serialisation
serialize->serialise
specialize->specialise
specialized->specialised
splendor->splendour
standardization->standardisation
standardized->standardised
summarized->summarised
synchronization->synchronisation
synchronize->synchronise
synchronized->synchronised
synchronizes->synchronises
unauthorized->unauthorised
unrecognized->unrecognised
utilize->utilise
utilized->utilised
virtualization->virtualisation
visualization->visualisation
