acknowledgment->acknowledgement
acknowledgments->acknowledgements
aggrandise->aggrandize
aggrandised->aggrandized
aggrandisement->aggrandizement
aggrandises->aggrandizes
aggrandising->aggrandizing
aluminum->aluminium
amortise->amortize
amortised->amortized
amortises->amortizes
amortising->amortizing
analog->analogue
analyze->analyse
analyzed->analysed
analyzer->analyser
analyzers->analysers
analyzing->analysing
apologise->apologize
apologised->apologized
apologises->apologizes
apologising->apologizing
armor->armour
armored->armoured
armoring->armouring
armors->armours
armory->armoury
artifact->artefact
artifacts->artefacts
authorisation->authorization
authorisations->authorizations
authorise->authorize
authorised->authorized
authorises->authorizes
authorising->authorizing
bastardise->bastardize
bastardised->bastardized
bastardises->bastardizes
bastardising->bastardizing
behavior->behaviour
behavioral->behavioural
behaviors->behaviours
biased->biassed
canceled->cancelled
canceling->cancelling
capitalisation->capitalization
capitalise->capitalize
capitalised->capitalized
capitalises->capitalizes
capitalising->capitalizing
catalog->catalogue
catalogs->catalogues
categorise->categorize
categorised->categorized
categorises->categorizes
center->centre
centered->centred
centers->centres
centimeter->centimetre
centimeters->centimetres
centralisation->centralization
centralise->centralize
centralised->centralized
centralises->centralizes
centralising->centralizing
characterisation->characterization
characterisations->characterizations
characterise->characterize
characterised->characterized
characterises->characterizes
characterising->characterizing
civilisation->civilization
cognizant->cognisant
color->colour
coloration->colouration
colorations->colourations
colored->coloured
colorful->colourful
colorfully->colourfully
coloring->colouring
colorizable->colourizable
colorization->colourization
colorizations->colourizations
colorize->colourize
colorized->colourized
colorizer->colourizer
colorizes->colourizes
colorizing->colourizing
colorless->colourless
colors->colours
colourisable->colourizable
colourisation->colourization
colourisations->colourizations
colourise->colourize
colourised->colourized
colouriser->colourizer
colourises->colourizes
colourising->colourizing
counselor->counsellor
criticise->criticize
criticised->criticized
criticises->criticizes
criticising->criticizing
crystallisation->crystallization
crystallise->crystallize
crystallised->crystallized
crystallises->crystallizes
crystallising->crystallizing
customisable->customizable
customisation->customization
customise->customize
customised->customized
customises->customizes
customising->customizing
daemonise->daemonize
daemonised->daemonized
daemonises->daemonizes
daemonising->daemonizing
decentralisation->decentralization
decentralise->decentralize
decentralised->decentralized
decentralises->decentralizes
decentralising->decentralizing
defence->defense
defenceless->defenseless
defences->defenses
demonise->demonize
demonised->demonized
demonises->demonizes
demonising->demonizing
deserialisation->deserialization
deserialise->deserialize
deserialised->deserialized
deserialises->deserializes
deserialising->deserializing
dialog->dialogue
dialogs->dialogues
digitisation->digitization
digitise->digitize
digitised->digitized
digitises->digitizes
digitising->digitizing
disfavor->disfavour
dishonor->dishonour
dishonorable->dishonourable
dishonored->dishonoured
dishonoring->dishonouring
dishonors->dishonours
donut->doughnut
donuts->doughnuts
economise->economize
emphasise->emphasize
emphasised->emphasized
emphasises->emphasizes
emphasising->emphasizing
enamor->enamour
enamored->enamoured
enamoring->enamouring
enamors->enamours
endeavor->endeavour
endeavored->endeavoured
endeavoring->endeavouring
endeavors->endeavours
enroll->enrol
enrollment->enrolment
enrollments->enrolments
enrolls->enrols
equalisation->equalization
equalise->equalize
equalised->equalized
equaliser->equalizer
equalises->equalizes
equalising->equalizing
equalizers->equalisers
favor->favour
favorable->favourable
favored->favoured
favoring->favouring
favorite->favourite
favorites->favourites
favoritism->favouritism
favorizable->favourizable
favorize->favourize
favorized->favourized
favorizes->favourizes
favorizing->favourizing
favors->favours
favourisable->favourizable
favourise->favourize
favourised->favourized
favourises->favourizes
favourising->favourizing
finalisation->finalization
finalise->finalize
finalised->finalized
finalises->finalizes
finalising->finalizing
flavor->flavour
flavors->flavours
focussed->focused
focusses->focuses
focussing->focusing
formalisation->formalization
formalise->formalize
formalised->formalized
formalises->formalizes
formalising->formalizing
fulfill->fulfil
fulfills->fulfils
generalisation->generalization
generalisations->generalizations
generalise->generalize
generalised->generalized
generalises->generalizes
generalising->generalizing
gray->grey
grayed->greyed
grayish->greyish
grays->greys
grayscale->greyscale
hemorrhage->haemorrhage
hemorrhaged->haemorrhaged
hemorrhages->haemorrhages
hemorrhagic->haemorrhagic
hemorrhaging->haemorrhaging
honor->honour
honored->honoured
honoring->honouring
honors->honours
humor->humour
hypothesise->hypothesize
hypothesised->hypothesized
hypothesises->hypothesizes
hypothesising->hypothesizing
initialisation->initialization
initialise->initialize
initialised->initialized
initialises->initializes
initialising->initializing
internationalisation->internationalization
internationalise->internationalize
internationalised->internationalized
internationalises->internationalizes
internationalising->internationalizing
italicise->italicize
italicised->italicized
italicises->italicizes
italicising->italicizing
journaling->journalling
judgment->judgement
judgments->judgements
kilometer->kilometre
kilometers->kilometres
labeled->labelled
labeling->labelling
labor->labour
labored->laboured
laborer->labourer
laborers->labourers
laboring->labouring
labors->labours
lambaste->lambast
lambastes->lambasts
legalisation->legalization
legalise->legalize
legalised->legalized
legalises->legalizes
legalising->legalizing
leukemia->leukaemia
licensing->licencing
liter->litre
liters->litres
localisation->localization
localisations->localizations
localise->localize
localised->localized
localises->localizes
localising->localizing
maneuver->manoeuvre
maneuvered->manoeuvred
maneuvering->manoeuvring
maneuvers->manoeuvres
marshaled->marshalled
marshaling->marshalling
math->maths
maximisation->maximization
maximise->maximize
maximised->maximized
maximises->maximizes
maximising->maximizing
memorisation->memorization
memorise->memorize
memorised->memorized
memorises->memorizes
memorising->memorizing
meter->metre
meters->metres
millimeter->millimetre
millimeters->millimetres
minimisation->minimization
minimise->minimize
minimised->minimized
minimises->minimizes
minimising->minimizing
miter->mitre
modeled->modelled
modeler->modeller
modelers->modellers
modeling->modelling
modernise->modernize
modernised->modernized
modernises->modernizes
modernising->modernizing
mold->mould
molds->moulds
nasalisation->nasalization
nationalisation->nationalization
nationalisations->nationalizations
nationalise->nationalize
nationalised->nationalized
nationalises->nationalizes
nationalising->nationalizing
neighbor->neighbour
neighboring->neighbouring
neighbors->neighbours
normalisation->normalization
normalisations->normalizations
normalise->normalize
normalised->normalized
normalises->normalizes
normalising->normalizing
ocher->ochre
ocherous->ochreous
ochery->ochrey
optimisation->optimization
optimisations->optimizations
optimise->optimize
optimised->optimized
optimiser->optimizer
optimises->optimizes
optimising->optimizing
organisation->organization
organisations->organizations
organise->organize
organised->organized
organiser->organizer
organises->organizes
organising->organizing
organizational->organisational
organizers->organisers
overwritable->overwriteable
parallelisation->parallelization
parallelise->parallelize
parallelised->parallelized
parallelises->parallelizes
parallelising->parallelizing
parameterisable->parameterizable
parameterisation->parameterization
parameterise->parameterize
parameterised->parameterized
parameterises->parameterizes
parameterising->parameterizing
paravirtualisation->paravirtualization
paravirtualise->paravirtualize
paravirtualised->paravirtualized
paravirtualises->paravirtualizes
paravirtualising->paravirtualizing
pasteurisation->pasteurization
pasteurise->pasteurize
pasteurised->pasteurized
pasteurises->pasteurizes
pasteurising->pasteurizing
penalise->penalize
penalised->penalized
penalises->penalizes
penalising->penalizing
plagiarise->plagiarize
plagiarised->plagiarized
plagiarises->plagiarizes
plagiarising->plagiarizing
polarise->polarize
polarised->polarized
polarises->polarizes
polarising->polarizing
practicing->practising
pretense->pretence
pretenses->pretences
prioritisation->prioritization
prioritise->prioritize
prioritised->prioritized
prioritises->prioritizes
prioritising->prioritizing
publicise->publicize
publicised->publicized
publicises->publicizes
publicising->publicizing
randomise->randomize
randomised->randomized
randomises->randomizes
randomising->randomizing
rasterisation->rasterization
rasterise->rasterize
rasterised->rasterized
rasterises->rasterizes
rasterising->rasterizing
rationalisation->rationalization
rationalise->rationalize
rationalised->rationalized
rationalising->rationalizing
realisable->realizable
realisation->realization
realisations->realizations
realise->realize
realised->realized
realises->realizes
realising->realizing
recognisable->recognizable
recognise->recognize
recognised->recognized
recognises->recognizes
recognising->recognizing
refocused->refocussed
refocuses->refocusses
refocusing->refocussing
refueled->refuelled
refueling->refuelling
regularisation->regularization
regularise->regularize
regularised->regularized
regularises->regularizes
regularising->regularizing
reinitialise->reinitialize
reinitialised->reinitialized
reinitialises->reinitializes
reinitialising->reinitializing
reorganisation->reorganization
reorganisations->reorganizations
reorganise->reorganize
reorganised->reorganized
reorganises->reorganizes
reorganising->reorganizing
reparameterise->reparameterize
reparameterised->reparameterized
reparameterises->reparameterizes
reparameterising->reparameterizing
rigor->rigour
routing->routeing
salable->saleable
sanitisation->sanitization
sanitise->sanitize
sanitised->sanitized
sanitiser->sanitizer
sanitises->sanitizes
sanitising->sanitizing
sanitizers->sanitisers
serialisation->serialization
serialise->serialize
serialised->serialized
serialises->serializes
serialising->serializing
signaled->signalled
signaling->signalling
skeptical->sceptical
skillful->skilful
skillfully->skilfully
skillfulness->skilfulness
specialisation->specialization
specialisations->specializations
specialise->specialize
specialised->specialized
specialises->specializes
specialising->specializing
specialties->specialities
specialty->speciality
splendor->splendour
standardisation->standardization
standardise->standardize
standardised->standardized
standardises->standardizes
standardising->standardizing
sterilisation->sterilization
sterilisations->sterilizations
sterilise->sterilize
sterilised->sterilized
steriliser->sterilizer
sterilises->sterilizes
sterilising->sterilizing
sulfate->sulphate
sulfide->sulphide
sulfur->sulphur
sulfureous->sulphureous
sulfuric->sulphuric
sulfurous->sulphurous
summarise->summarize
summarised->summarized
summarises->summarizes
summarising->summarizing
symbolise->symbolize
symbolised->symbolized
symbolises->symbolizes
symbolising->symbolizing
synchronisation->synchronization
synchronisations->synchronizations
synchronise->synchronize
synchronised->synchronized
synchroniser->synchronizer
synchronises->synchronizes
synchronising->synchronizing
synchronizers->synchronisers
synthesise->synthesize
synthesised->synthesized
synthesiser->synthesizer
synthesises->synthesizes
synthesising->synthesizing
synthesizers->synthesisers
tidbit->titbit
tidbits->titbits
totaled->totalled
totaling->totalling
unauthorised->unauthorized
unfavorable->unfavourable
unfavorably->unfavourably
uninitialised->uninitialized
unorganised->unorganized
unrecognisable->unrecognizable
unrecognised->unrecognized
unsynchronised->unsynchronized
utilisable->utilizable
utilisation->utilization
utilise->utilize
utilised->utilized
utilises->utilizes
utilising->utilizing
vectorisation->vectorization
vectorisations->vectorizations
vectorise->vectorize
vectorised->vectorized
vectorises->vectorizes
vectorising->vectorizing
virtualisation->virtualization
virtualise->virtualize
virtualised->virtualized
virtualises->virtualizes
virtualising->virtualizing
visualisation->visualization
visualisations->visualizations
visualise->visualize
visualised->visualized
visualiser->visualizer
visualises->visualizes
visualising->visualizing
writable->writeable
