amortised->amortized
analyse->analyze
analysed->analyzed
analyser->analyzer
analysers->analyzers
analyses->analyzes
analysing->analyzing
artefact->artifact
artefacts->artifacts
behaviour->behavior
cancellation->cancelation
cancelled->canceled
cancelling->canceling
capitalise->capitalize
catalogue->catalog
centimetre->centimeter
centimetres->centimeters
centralise->centralize
centre->center
characterised->characterized
colour->color
colouring->coloring
colours->colors
counsellor->counselor
criticised->criticized
customisable->customizable
customising->customizing
dialogue->dialog
digitise->digitize
digitising->digitizing
emphasised->emphasized
flavour->flavor
flavours->flavors
initialisation->initialization
initialise->initialize
initialised->initialized
initialises->initializes
initialising->initializing
kilometre->kilometer
kilometres->kilometers
labelled->labeled
labelling->labeling
labour->labor
licence->license
licenced->licensed
licencing->licensing
manoeuvering->maneuvering
manoeuvre->maneuver
manoeuvres->maneuvers
memorise->memorize
metre->meter
metres->meters
millimetre->millimeter
millimetres->millimeters
minimise->minimize
minimising->minimizing
mitre->miter
modelled->modeled
modelling->modeling
mould->mold
organisation->organization
parallelising->parallelizing
parallelled->paralleled
parallelling->paralleling
parametrise->parametrize
prioritise->prioritize
prioritising->prioritizing
proveable->provable
rasterisation->rasterization
rasterise->rasterize
realise->realize
resizeable->resizable
sanitisation->sanitization
sanitised->sanitized
serialisation->serialization
serialise->serialize
specialise->specialize
specialised->specialized
uninitialised->uninitialized
utilise->utilize
utilised->utilized
vectorisation->vectorization
vectorise->vectorize
writeable->writable
