ablet->able, tablet,
afterwords->afterwards
amination->animation, lamination,
aminations->animations, laminations,
aminator->animator, laminator,
ans->and
arithmetics->arithmetic
attache->attaché, attached, attach,
automatize->automate
automatized->automated
automatizes->automates
backword->backward
backwords->backwards
bale->able, bail,
bellow->below
bloc->block
blocs->blocks
bodgy->body
bu->by
buss->bus
busses->buses
calculatable->calculable
calender->calendar
calenders->calendars
cancelability->cancellability
cant->can't
chack->check, chalk, cheque,
chancel->cancel
chancels->cancels
circularly->circular
commata->commas
commend->comment, command,
commends->comments, commands,
compliancy->compliance
complier->compiler
compliers->compilers
confectionary->confectionery
consequentially->consequently
coo->coup
copping->coping, copying, cropping,
covert->convert
crasher->crash
crashers->crashes
crate->create
crated->created
creche->crèche
cristal->crystal
crufts->cruft
dealign->dealing
deffer->differ, defer,
degrate->degrade
degrates->degrades
dependant->dependent
derails->details
discontentment->discontent
discreet->discrete
fallow->follow
fallowed->followed
fallowing->following
fallows->follows
fave->save
floaw->flow, float,
floaws->flows, floats,
florescent->fluorescent
followings->following
forewarded->forwarded
formule->formula, formulas,
formules->formulas
fount->found
fro->for, from,
froward->forward
fulfilment->fulfillment
gird->grid
girds->grids
guarantied->guaranteed
guerilla->guerrilla
guerillas->guerrillas
hart->heart, harm,
heterogenous->heterogeneous
hided->hidden, hid,
hove->have, hover, love,
impassible->impassable
implicity->implicitly
inactivate->deactivate
incluse->include
indention->indentation
indite->indict
infarction->infraction
inly->only
irregardless->regardless
knifes->knives
leaded->led, lead,
leas->least, lease,
lightening->lightning, lighting,
loafing->loading
lod->load, loud, lode,
loos->loose, lose,
loosing->losing
lousily->loosely
lumination->lamination, illumination,
mane->main, many, Maine,
manger->manager
marge->merge
mater->matter, master, mother,
medias->media, mediums,
meu->menu
meus->menus
midwifes->midwives
moil->soil, mohel,
mot->not
moue->mouse
multistory->multistorey, multi-storey,
nickle->nickel
noes->nose, knows, nodes, does,
oerflow->overflow
oerflowed->overflowed
oerflowing->overflowing
oerflows->overflows
ore->or
panting->painting
pares->pairs
patter->pattern
patters->patterns
pavings->paving
payed->paid
planed->planned
pleas->please
predicable->predictable
preform->perform
preformed->performed
preforms->performs
pres->press
prioritary->priority
programed->programmed
programing->programming
prosses->process, processes, possess,
purportive->supportive
purvue->purview
ques->quest
readd->re-add, read,
readded->read
ream->stream
recuse->recurse
remainer->remainder
remainers->remainders
retuned->returned
retying->retrying
revered->reversed
rime->rhyme
rouge->rogue
sate->state
sates->states
savable->saveable
scrip->script
scrips->scripts
setts->sets
shat->that, shit,
sightly->slightly
simplication->simplification
singe->single
singed->signed, singled, sang, sung,
slippy->slippery
specif->specify, specific,
statics->statistics
steams->streams
sting->string
stings->strings
straightaway->straight away
straighted->straightened, straighten,
suppressable->suppressible
therefor->therefore
therefrom->there from
theses->these, thesis,
thur->their
tittle->title
tittles->title
toke->took
tread->thread, treat,
trough->through
unknow->unknown
unknows->unknowns
unsecure->insecure
untypically->atypically
vertexes->vertices
vie->via
vise->vice
want's->wants
wee->we
whats->what's
whet->when, what, wet,
whiling->while
wight->weight, white, right, write,
wights->weights, waits, whites, rights, writes,
wile->while
wit->with
withe->with
wither->either, whether, weather,
withing->within
wont->won't
wounder->wonder
zoon->zoom
